NO ./img/wall_n.xpm
SO ./img/wall_s.xpm
WE ./img/wall_w.xpm
EA ./img/wall_e.xpm

F 64,     64,    64
C 153,    255,   255


     1
    101
   10001
  1000001
 100000001
11111111111
 111111111
10000E00001
 100000001
  1000001
   10001
    101
     1